MMMMMMMMMMMMMMMMMMMMMMMMM
MNNNNNNNNNNNNNNNNNNNNNNNM
MNNNNNNNNNIIIINNNNNNNNNNM
MNNNNNNNNNNNNNNNNNNNNNNNM
MNNNNNNNNNNNNNNNNNNNNNNNM
MNNNNNNNNNIIIINNNNNNNNNNM
MNNNNNNNNNNNNNNNNNNNNNNNM
MNNNNNNNNNNNNNNNNNNNNNNNM
MNNNNNNNNNNNNNNNNNNNNNNNM
MNNNNNNNNNNNNNNNNNNNNNNNM
MMMMMMMMMMMMMMMMMMMMMMMMM